1111111111
1P0000C1E1
11111101C1
1111110001
1111111111
