11111
1E001
10101
10101
1P0C1
11111
