11111
1E001
10101
1P101
100C1
11111
