11111111
1E1000P1
11C00001
11111111
