1111111111
1P100000E1
111111CCC1
1111111111
