111111111
11C1111E1
101011101
100C000P1
111111111
