11111111
100000C111
10000001
1P0000E1
11111111
