11111111
1EE00001
1C0000P1
11111111
