11111111
1P000P01
1C0000E1
11111111
