1111111
111E111
1P111C1
1111111
